Shukria - Hindi
Evharisto - Greek
Khob khun krub - Thai
Kahm sahm needah - Korean
Obrigado/a - Portugues
Gracias - Spanish
Grazie - Italian
Danke - German
Arigato - Japanese
Merci - French
Todah - Hebrew
Xie xie - Mandarin
Salam'at - Tagalec (how are you? = como esta?)
Cam o'n ban (or) Kam' Un - Vietnamese
Terima kasih - Malay
Asante - Swahili
Meh-h'n-s'lah - Arabic
Shokran - Arabic/Lebanese
Buhem - Walif(Senegnal-Dakar)
(ASL == Navajo SL) (Navajo starts under the chin more, sweeps out and slightly up)
Mahalo - Pacific Island (Samoa?)
Hm'Gauy - Cantonese
Sepås gozåram - Farsi (Persian)
Dankjewl - Dutch
Spasibo - Russian
Multumesc (Frumos) - Romanian
Fala - Bosnian
Malayalam - Nandi (India - Sanskrit)
Dhanyadaalu - Telugu (India)
Merci, Bototo, Matondo - Lingala (Zaire)
Twasakidila - Tshiluba (Zaire)
